####################
#                  #
#                  #
#                 G#
#                ###
#                  #
#                  #
#       ###        #
#       ###        #
# S   ^ ###    >   #
####################

